****A****
*       *
*       *
*   o   *
*       *
*********
