    **
  **  **
**  k   **
*         *
A         *
*     *****
***********
