************A************
*                       *
*                   *** *
*  **       ?       *   *
*************************
