****D****
*       *
*       *
*       *
*   o   *
*   n   *
*********
