*********D*****
*             *
*             *
*         k   *
*         n   *
***************
