****************
*              *
D         ? n  *
*              *
****************
