**************SUCCESS**************
*                                 *
*                A                *
*          o     k      ?         *
*                                 *
*                                 *
***********************************
